                                                            .:::::::: :         
                                                            -  .....  :         
                                                            :   :.:::::         
                                                             :..:               
                                                             -. :               
                                                             :. ..              
                                                              :. :.             
                                                              :...:             
                                      .:.      .-----          -.. :.           
                                   .:--:-:   .-:.....-:        :....:.          
                                  :-:::::=  --:.:=-..--=        -....-.         
                                 :-==-:::= -:::-*+#+.:+:        :.....:.        
                       -.        -:##=-::=:-:+*#####+=.-         -..:..:        
                      :+:        --##+::::#+######***#*-.         :-+*.:        
                     :**        :=.*%@=-:-%##***##+++*#*-         .=##.-        
                   -++==-:.    ..: =@@:-:=%##***##+++**#=         .%%*.-        
               -=+#*+=+=*==+-:::.. :@%=-:+#*****#*++*###=         +%%-.-        
              ###**+*+*##++***+-    @#*--+#%#%*##*+*+#*#=         %#%:.-        
             +@*****+**#*:          #%%  +%@%@#*##*+*###-        -#@*:::        
            :%@##******##*.         +@@. =@@%@@*##***##%-        %@%-:-         
           =%%%#######*##*.         :%%- =@%@@@%##***###-    :- -@%+::-         
          -@@@%##-. .*##+.           @%+ -%%==@%###**#*#- .:-:-:#%@.-:.         
          -@@@@@%.   :=:             *%% -@@. +%##@@@@%#=-:::::=@@*::-          
          #@%#@@=                    =#%.-@@#=@##%%%@@@#=::-:::#%%:-=.          
         *%@@%@@=                    :@%=:%@%%%#+#@#@@@#::-.  .@#*-::           
        *@@@@@@@:                     @@*:%###*+++@@@@%=:-.   *%@=--.           
        @@@#@@@+                      %%@:%*#*++++*%%%%:-    .@@#               
       :@@@%@@#=                      *%%+%##**+++**##+:. .: *%@=               
       #%@@@@@#-                      +@#**##***++**#%-:-.-:+%%@                
      :%@@%@@@#-                     -*%%=+%#***+**###::-.=-+#%#                
      *%@#%@@@#:                    :+###=%%%*****##%*:-  -#+*%*=               
     :@@%#%%%**             .:::.    #%#*+*#%#****#%%*==-.=%@###+:              
     .@@%%%**+*           :=++-=+=--+=+%@%##%%###%%%%@%*+#%@@@%**.              
     :%@%%#*++#   :---+%*++@@@*==..-%@%****#%%%%%%%#%#*%%@@#*%*                 
     +#%%%#*+*#--+*#%%#***@@@@@@*+*+@%%##*##%%%%%%%#%###%%##*.==:               
     *#%######*==%@@@@@@@@@@@@@##**##**##**#%%%%###%%#####%%%*=+#*:             
     ###%###%*++*@@@@@@@@@@@@@@****######**###%%%%%%***#%@@@@#*##*%.            
    :###***###***@@@@@@@@@@@@@@*++*%@%#*****##%%%%#*+***%@#*#%**#@#*            
    +##**########@@@@@@@@@@@@@%*++*@@@%%##***##%%##**###%%###@++#@@@-           
    +#####***###%@@@@@@@@@@%%@%*++#@%@@%#*****##%###*####@@@@@#+*@@@#           
     *###########@%@@@@@@@@@#@%*++###*#@#******#%#*******%%%%%%+*%@@@:          
      +##%%#######%%%%#%%@@@#%%*+*#####@#******#%#********#*#*%%#%@@@+          
       -+*#%%###%####%@@%#@@%###**#@@@@%##*##**#%#*****#######*%%%@@@%          
           .-+#%#####%@@@@%%%%%##*@%%%%%##*#####%#*######****#*%#@@@@@.         
                :-=+++++=:   .%#*%@%%###******##%###*#******###%%@@@@@:         
                              %**%@%%#####*****##@#********####%@@@@@@:         
                              +#*@@@%############%######*######%@@@@#%.         
                              .%%@@@@###########%%###########%@%@@@@%%          
                               *@@@@@###########%%########%%%%@@@@@@%%          
                               -@@@@@%#######%%%%@%%%#####%%@@@@@@@@@@.         
                                @@@@@%%%%##%%%%##%%%%%%%%%#%@@%%@@@@@%-         
                                +@@@@@@@@%%%%%##%%%#%%%%%%%@@#*#@@@@@@=         
                                .@@@@@@@@%###%%%%%%%#%#####%%##%@@@@@@*         
                                 +@@@@%%@%#%%##*#%#**###%##%%@@@@@@@@@*         
                                  @@%***%@%####*#%######%##%%%@@@@@@@@#         
                                  +@@##@@@%######%######%%##@%%@%@@@@@#         
                                   %@@@@@%%######%%######%%%###@%%@@@@#         
                                   .@@@@@%%######%%######%%####@%%@@@@#         
                                    +@%%##%####%%@@%%####%####%@##%@@%%         
                                     @%###%%#####%@%####%%####%@#####%%.        
                                     +%%##%######%%#####%#%###%@%######=        
                                     .@%##%%#####%@#####%%###%@#%%######        
                                      @@###%%####%%####%%%###@@=#%####*#=       
                                      @%%###%%%##%%%##%%%###%@@:+#####*#*       
                                      @@%##%#####%@%####%###%@@.-##*##*#%.      
                                     .#%%##%######@##%##%###%%@ :##**#%%#%      
                                     :#%%###%#####@#####%###%@@ :###%%%@@@      
                                     +@@%%##%%####@####%####%@@  %##%*%@@%      
                                     *++##%##%%###%###%#######*: ###%*%@@%      
                                   .+==@%%#######%%##%####%%%@#=+*#%%#@@@#      
                                  -+*=+@#%########%#####%#%##%%*+%@%@#%@@*      
                                 -++*+***##%%######*####%%##**#**#%%@#%@@*      
                                -+***+****%%###########%%%%#**#+**%%@#%@@*      
                               .+***++****%*+***#*****#*+*##**#++*%%@@%%*=.     
                               :****+*****#++++##@#*#@#*+++#***+++%@@@@@@#:     
                               -****++****#++++#%@#*%@##+++#***+++%@@@@@@*:     
                               -****++****#+++*#%#%##@##+++%***+*+#@@@@%@+      
                               -*+*+**#***#*+++##@%#@@#*++*#*****++%@@@@@+      
                               -*****#*+**%#*++*#######*++*%*++#**+%@@@%%@.     
                               :**##*+++**%%%%%%##########%%*+****#%@@@@@@      
                               :##++++++**%######%##%%%#%%%%****+++%@@@@%@      
                               :*+++++**+*@%%%%###%#%%###%%%+++***+*@@@@@@.     
                               :+++*****+*%%###%##%#%#####%%*+******%@@@@@.     
                               :*********%%#%#####%#%####%##%#******%@@@@@      
                               .*****##%%%###%######%###%%####%%%##*#@@@@@:     
                                .**%@@@@%%####%#########%#######%@@*#@@@@@:     
                                   @@@@@%%####%########%%########@@#=@@@@%      
                                  :@@@@@%######%#####%%%#########%@%+%%@@@      
                                  -%@@@@@#######%#%##%%%##########@@#*##@@:     
                                  =%@@@@%#######%%##%%%#########%#@%***#%@=     
                                  +%@@@@%########%###%###########%%%***##@*     
                               .**%%@@@@%########%#++%############%%*#**##*     
                               =%%#%@@@@%######%##+  #############%%*##*##*     
                               =###%@@@@%######%##*  +############%%*%#*##+     
                               +**%%@@@@%#######%##  -#############%#+####-     
                               +*+%%%%%%####%#%%%%#   %############%#####*      
                               ++**===+++++++*****%   *###########%#%%#%*       
                               =***+===++++++*****#.  :%%##########%@##%:       
                               =+*%%%%%%%###%%%###%.   *%##########%###:        
                               =++%%@@@@%#########%.   :%##########%%%          
