::::::::::::::::::::::::::::::::::::::::::::::::::::::::::::::::::::::::::::::::
::::::::::::::::::::::::::::::::::::::::::::::::=-::::::::::::::::::::::::::::::
::::::::::::::::::::::::::::::::::::::::::::::::*-::::::::::::::::::::::::::::::
::::::::::::::::::::::::::::::::::::::::::::::::%=::::::::::::::::::::::::::::::
::::::::::::::::::::::::::::::::::::::::::::::::@+::::::::::::::::::::::::::::::
:::::::::::::::::::::::::::::::::::::::::::::::-@%-:::::::::::::::::::::::::::::
:::::::::::::::::::::::::::::::::::::::::::::::=@@%-::::::::::::::::::::::::::::
:::::::::::::::::::::::::::::::::::::::::::::::+@@@%-::::---:::::::::::::+::::::
:::::::::::::::::::::::::::::::::::::::::::::::*@@@@@++=-....:--::::::::#*::::::
:::::::::::::::::::::::::::::::::::::::::::::::#@@@@@%-::......-=:::::-%@+::::::
:::::::::::::::::::::::::::::::::::::::::::::::%@@@@@+-::.......-+::=*@@@=::::::
:::::::::::::::::::::::::::::::::::::::::::::::@@@@@%=-::........=#@@@@@@:::::::
::::::::::::::::::::::::::::::::::::::::::::::-@@@@@*=-::.........%@@@@@#:::::::
::::::::::::::::::::::::::::::::::::::::::::::=@@@@@+=--::........*@@@@@+:::::::
::::::::::::::::::::::::::::::::::::::::::::::=@@@@@+=--:::.......=@@@@@-:::::::
::::::::::::::::::::::::::::::::::::::::::::::=@@@@@#==-::::......=@@@@#::::::::
::::::::::::::::::::::::::::::::::::::::::::::=@@@@@@+=--:::::....+@@@@+::::::::
::::::::::::::::::::::::::::::::::::::::::::::-@@@@@@*==--:::::.::*@@@%:::::::::
:::::::::::::::::::::::::::::::::::::::::::::::%@@@@@%+==---:::::-#@@@*:::::::::
:::::::::::::::::::::::::::::::::::::::::::::::*@@@@@@++=+---:::-=@@@@-:::::::::
:::::::::::::::::::::::::::::::::::::::::::::-*#@@@@@@#-:-==::::=#@@@+::::::::::
::::::::::::::::::::::::::::::::::::::::::::=#==%@@@@@@::-:=...:#@@@#:::::::::::
:::::::::::::::::::::::::::::::::::::::::::*#*=*+#@@@@@*:=:-...=@@@@=:::::::::::
:::::::::::::::::::::::::::::::::::::::::-%#+*#%#-@@@@@@++:=:--@@@@%@+-:::::::::
::::::::::::::::::::::::::::::::::::::::+@%++#@@#-@@@@#@@***=+%@@@#+%#=-::::::::
:::::::::::::::::::::::::::::::::::::::-*@*+*%@@==@@@@**@##**#@@@@@*+*=-*:::::::
:::::::::::::::::::::::::::::::::::::--..+++*@@%=:@@+@@@@@*+#%*#@@@@+*.=@#-:::::
::::::::::::::::::::::::::::::::::::-#+...**%@@@+:+**+@@@#*#@@@@@%@@%*.-@@*=::::
:::::::::::::::::::::::::::::::::::-%@%+..-#@@@@*::**#+#@=-+@@#%@%@@@%::#@:=+-::
::::::::::::::::::::::::::::::::::-#@@#++.:#@@@@+--*%==+%+:##*##*#@@@@+=@*+*+%=:
:::::::::::::::::::::::::::::::::==#%%++#=-*@@@@=-+=%*#*++-##%#+##%@@%#@@+=..%@#
:::::::::::::::::::::::::::::::-=+=@-=#%@%=+@@@@#=+=*#++--=**#+++%@@@%+@%#=..#@@
::::::::::::::::::::::::::::::=+..:@@@*@@@*+#@@@#*=-##*#%*#%*@*+=*%@@%=%=:%-:+*%
:::::::::::::::::::::::::::::=@@#--+=*%%@@%*#@@@*+=**+#++**#%###*#@@+==@-.-*=*+*
::::::::::::::::::::::::::::+@@#+*+:..=*#+#@=:#%*=*==+#%*+*#%@%@%-%@-.-%-:.*#%%+
:::::::::::::::::::::::::::+@@#==+++..:=*==+#::%#=-=+=**%%@%@%#*##@@:.:%+::+@@@#
::::::::::::::::::::::::::=@@@#--=*#+::=+*+::+.=@-.==-:-+*@#%+:...*@==++%-:#@@@%
:::::::::::::::::::::::::-@@@@*:-=*##+:=*%:..::.%*=:.:.=*++%#+=:..-@..+*#+=%@@@@
:::::::::::::::::::::::::%@@@#-:-*@@@@==#+:..:.:-#....-:.:-#@+=:..:%.::=%*#%@@@@
::::::::::::::::::::::::*@@@#==*#%@@@@%=%-::::::.#..:....:=*@#-:...*::--+##%@@@@
:::::::::::::::::::::::-@@@@=*%@@@@@@@#**-:::==..+::....:-*#*@=:...-:-==+##%@@@%
:::::::::::::::::::::::#@@@+-#%@@@@@@#*#+---=#-::==......:=%+#=::..::-==*##@@##*
::::::::::::::::::::::=@@#+*%#####@@@%#@%+==#+--=+:.....::-***=-:..::-=**#%@*:+=
::::::::::::::::::::::###%@*#.=:.-#%@@@@@#*#++=+*-:.....::-=*++-::.::=+**%@@++%%
::::::::::::::::::::::#%@@@+#.-+..#%%@@@%*#@#*+*=-::....::-=*++=-:::+*#+#@@@@@@#
::::::::::::::::::::::=%@@#+#=:#.:*+%@@@@%%#*#*+=-:::...::-+#+++=-:==**+@@@+#%=:
:::::::::::::::::::::::-*%..#%=#-+-=#%@@@@@#++*+=-:::...:-=+#+#++=--=%*#@@*:-:*:
::::::::::::::::::::::::=+..-@@@**--+%@@@@#**++*+-:::::::-=+@+%+++=+#%#@@@*:=:+-
::::::::::::::::::::::::+=..:%@@@#==*#@@@@%##*++*+-:::::-=++@+%++++#@%@@%**:=:-+
::::::::::::::::::::::::=+:.:+@@@@*+*@@@@@@@@%***#+-:::--=++@+@#+*@@@@@@@#+:=::+
:::::::::::::::::::::::::#=::-%+#++@@@@@@@@@@@%*##@+----=*%%%-@@%@@@@@@%@@+:-::*
:::::::::::::::::::::::::+%::-*...+#%:-#@@@@@@@%##@@+==+#@@#=:*%#=*%@*-+#@=----*
:::::::::::::::::::::::::+#+-++..:=+=.-#@@@@@@@@@%%%@##@@@*..=...:%@=:--%*=--+-+
:::::::::::::::::::::::::+=+=+=---==-.-%@@@@@@@@@@@@@@%#=:...=..:+@=:+-+#*=--*-*
:::::::::::::::::::::::::*+%:*:.:+==.:=@@%#*#*+=+*@@@@-.....-%#*=%**%*=%#*=--#=#
:::::::::::::::::::::::::+**:==-.-::::+@%#*+=*+-:..=%@@=:::=@@@=-*=+*##@@*=-=%#@
:::::::::::::::::::::::::++#=-*::--::-*@+#*##%*+-:..:+%%=-*@@@*---=++#@@@#===#@*
:::::::::::::::::::::::::+#-+=#-:--+:-%@=#*#***++=::*#====++@*=---+#%@@@@%+=*%@*
::::::::::::::::::::::::-#:.++#==-==-+%@@@@@%#@%+===#+=----+@*==-+%@@@@%@@**@@@+
:::::::::::::::::::::::-*:.=*###*=*==#*+@@@@@@%##**%%+=---=#*##*###*@@@#@@@@@@*#
:::::::::::::::::::::::*:..:+%%=*+#=#@=:*@@@@@%**%@@#+==+=-=+*#+--=%@@@*+@@%@@=@
::::::::::::::::::::::=*=-.:=*@++%+%@%:::+@@@@@@#%@@@%%*=::-=%+=:-*@@%*#%%@@@##@
::::::::::::::::::::::%#*+*-=+@#%@%@@=::::*@@@@@@@@@@@%*=::-+%+=--%%*%@#*#@@@++%
:::::::::::::::::::::=%#*++*++@@@@@@#:::::=@@@%%%%%%@@@@+-=+*%%*=+##%@#**#@*@==#
:::::::::::::::::::::=@@%*++#*%@@@@@#::::::@@@*+****#%#+#=+##%%##%#@@#**#%@+#++*
::::::::::::::::::::::#@@%++*#@@@@@@#::::::%#%%%%%%@@@@@%*+*%@@%@@@@%#*#@@@*=#**
::::::::::::::::::::::%#%@*+*#%@#%*@=::::::#%##*++***#%@@@@@@*++@@#@%#%@@@@@%@%%
:::::::::::::::::::::=%**@*+*#%@=*-@+::::::+%%%#*++**###%@@@@@#%@%+%@@@@@@@%#@@#
:::::::::::::::::::::*#*+%#++#%@=+-@#::::::=@@@@@@%#*####%@#@@@@@%*%@@@@@@@@#%@#
:::::::::::::::::::::%#*+##*+*%@%-+%%::::::=@@@@@@@@@%###%@**%@@@@@@@@@@@@@@##@%
:::::::::::::::::::::%#*+*%***%@%##%%-:::::%@@@@@@@@@@@@%%@*%@@##%@@@@@@@@@@%#%@
:::::::::::::::::::::@##++#**#%@%*#%%=::::-@@@@@@@@@@@@@@@@@@@#*#@@@@@@@@@*%@##@
:::::::::::::::::::::%%#*+***@%%%*%#@=::::+@@@@#%@@@@@@@@@@@@@@@@@@@@@@@@@=+%@##
:::::::::::::::::::::##%*+***%###*##@-::::*@@%@=:#@@@@@@@@@@@@@@@@@@@@@@@#-=*@@#
:::::::::::::::::::::**@#+**##%***#%%:::::*@%#@:..%@@@@@@@@@@@@@@@@@@@@@@--=+@@@
:::::::::::::::::::::**@%*#####*##%@+:::::#@##@...=@@@@@@@@@@@@@@@@@@@@@%::-+%@@
:::::::::::::::::::::+*%#*#%#%#%%@@%::::::%@##%...:%@@@@@@@@@@@@@@@@@@@@%:::=#=@
:::::::::::::::::::::-@%**#%@#@@@@%=:::::#@%**#...:*@@@@@@@@@@@@@@@@@@@@@=::=#-+
::::::::::::::::::::::%%*+#%%%@@@%+:::::*@%#*#*...:*@@@@@@@@@@@@@@@@@@@+%#::=*=:
::::::::::::::::::::::*#+=#@%%%@@=:::::=@%%**#+...:**@@@@@@@@@@@@@@@@@@*:#::=%+:
::::::::::::::::::::::*#+*%@##%@=::::::%%%**##-...-*+@@@@@@@@@@@@@@@@%+@:--.#@++
::::::::::::::::::::::##%%=+:-%*::::::+@##**##:...-+=#%@@@@@@@@@@@@@@+-@+.-.*+++
:::::::::::::::::::::-%#*-+=-=+#-:::::#%##*##*....-+=%=#@@@@@@@@@@@@%::%#...*=+-
::::::::::::::::::::::#*-:=#**=**::::-@#*###%=....-+=%=-@@@@@@@@@@@@*::+@:..+-+:
::::::::::::::::::::::#@-=#@%%*##::::+@#*###%:....-+=%=:%@@@@@@@@@@@@-:=#-..=-=:
::::::::::::::::::::::%*-=%%%%#*#::::#%*###%=.....=+=%-:#@@@@@@@@@@@@*:=+=..-:=:
:::::::::::::::::::::-#-=###%%#*#::-:@#*###*.....:=*+%::#@@@@@@@@@@@%%--=+....+:
:::::::::::::::::::::*+-+*%%%%#*#:=##@#*%#%:.....:=*+#:-#%@@@@@@@@@@*#+:-+....*:
:::::::::::::::::::::%--=*#%#%%#%++**@#*@%+:.....:=*=*:-#*@@@@@@@@@@-+#:==....+=
::::::::::::::::::::-%*-+*###%%%#*##**%#@#:......:=#++:-@+@@@:+@@@@#:-#:+-....-#
::::::::::::::::::::=*=-*##*##%%*+*%**%%@=:.:-...:=#++:+%*@@#:=@@@@-.:+-+-....:%
::::::::::::::::::::=+--+%##%#%%#+*%#%#@*::.+-...:=#*=:#*#@@=::@@@*:..:=-+....:*
::::::::::::::::::::=#+=*#%%%%%%#**%#%#@-:::%:...:=#*--@+%@@:::%@@-:..:=:#....-=
::::::::::::::::::::+%#**#%###%**##%%#@*-::+-....:=##-+@=@@#:::#@@=:...-:#....--
::::::::::::::::::::++%%*#*+*##*#%@@@%@=:::*:....:=##=##+@@=:::*@@*:...-:#:::.+-
::::::::::::::::::::++:=@#**#%#*%#%#@@#-::-+:....:=##=%*#@@::::+@%%=:..::+--*:+-
::::::::::::::::::::=*:-@%#%%####=#%@@+-::*=:....:=##+@+%@*::::+@#@+-..:---:@++-
::::::::::::::::::::-#::%+#%%%##+*#%@@=-::#-:....:=***%*@@=::::=@%#@=:.:-*-:%@#=
:::::::::::::::::::::#::+=:=#-**-%#%@#=:::#=:....:=#*##%@%:::::-@@+@%-:.-#=-#-#*
:::::::::::::::::::::*-:-=::*=::-@#%@*-:::#=::...:=#*%*@@+::::::%@**@*::-#+-+:-*
:::::::::::::::::::::-+::=:::=::=%#%@+-::=#=::...:=#*@%@%:::::::*@#=*%-:=%*-+::+
